6000000000000000005
1  B   B   B   B  1
1 605 1 000 1 605 1
1B1 1B1     1B1 1B1
1 403 1 1 1 1 403 1
1     1B1 1B1     1
1 60003 1 1 40005 1
1B1 B         B 1B1
1 1 00000B00000 1 1
1   B         B   1
1 00000 605 00000 1
1  B    1 1 B     1
1 605 1 403 1 605 1
1 1 1 1  B  1 1 1 1
1 403B1B605B1B403 1
1B    1 1 1 1    B1
1B00003 403 40000B1
1       XXXO      1
4000000000000000003
