6000000000000000005
1  B   B   B   B  1
1 00000 1 1 00000 1
1B   B  1 1  B   B1
1 015 113 411 111 1
1 1 1  B   B  1 1 1
1 403 0000000 403 1
1B  B         B  B1
100 00000B00000 001
1   B         B   1
1 0000005 6000000 1
1  B    1 1    B  1
1 00005 1 1 60000 1
1     1  B  1     1
1 1 1B1B1 1B1B1 1 1
1B1 1   1 1   1 1B1
1B1 40003 40003 1B1
1       XXXO      1
4000000000000000003