1111111111111111111
1  2   2   2   2  1
1 1 1 1 1 1 1 1 1 1
12   2       2   21
1 1 1 1 1 1 1 1 1 1
1      2   2      1
1 1 1 1 1 1 1 1 1 1
12  2         2  21
1 1 1 1 121 1 1 1 1
1   2         2   1
1 121 1 1 1 1 121 1
1        2        1
1 1 1 1 1 1 1 1 1 1
1    2 2     2 2  1
121 1 1 1 1 1 1 121
1                 1
121 1 1 1 1 1 1 121
1                 1
1111111111111111111